********************************************************************
********************************************************************
********************************************************************
*------------------------------------------------------------------*
*------------------------------------------------------------------*
*------------------------------------------------------------------*
*T----------------------------------------------------------------T*
*------------------------------------------------------------------*
*------------------------------------------------------------------*
*------------------------------------------------------------------*
*------------------------------------------------------------------*
********************************************************************
********************************************************************
